3;4;4;4;4;4;4;4;4;4;4;4;5
6;7;7;7;7;7;7;7;7;7;7;7;8
6;7;7;7;7;7;7;7;7;7;7;7;8
6;1;7;7;0;7;7;2;7;7;7;7;8
6;7;7;7;7;7;7;7;7;7;7;7;8
6;7;7;7;0;7;7;7;7;7;7;7;8
6;7;7;7;7;7;7;2;7;7;7;7;8
6;7;7;7;7;7;7;2;7;7;7;7;8
6;7;7;7;7;7;7;10;7;7;7;7;8
6;7;7;7;7;7;7;10;7;7;7;7;8
9;10;10;10;10;10;10;10;10;10;10;10;11
